 2  2  2  2  2  2  2  2  2  2  2  2  2  2  2  2  2  2  2  2  2  2  2  2  2  2  2  2  2  2  2  2  2  2  2  2
 2  2  1  0  1  1  0  0  0  1  1  0  0  2  2  2  2  2  2  1  0  1  1  0  0  0  1  1  0  0  1  2  2  2  1  0
 2  2  9  9  9  9  9  9  9  9  9  9  9  9  2  2  2  9  9  9  9  9  9  9  9  9  9  9  9  9  9  9  9  9  9  9
 2  2  9  9  9  9  9  9  9  9  9  9  9  9  2  2  2  9  9  9  9  9  9  9  9  9  9  9  9  9  9  9  9  9  9  9
 2  2  9  9  9  9  1  1  1  9  9  9  9  9  2  2  2  9  9  9  9  9  9  9  9  9  9  9  9  9  9  9  9  9  9  9
 2  2  9  9  9  9  9  9  9  9  9  9  9  9  1  1  1  9  9  9  9  9  9  9  9  9  9  9  9  9  9  9  9  9  9  9
 2  2  9  9  9  9  9  9  9  1  1  1  9  9  9  9  9  9  9  9  9  9  9  9  9  9  9  9  9  9  9  9  9  9  9  9
 2  2  9  9  9  9  9  9  9  9  9  9  9  9  9  9  9  9  9  9  9  9  9  9  9  9  9  9  9  9  9  9  9  9  9  9
 2  2  9  9  9  9  9  9  9  9  9  9  9  9  1  1  1  1  1  1  1  9  9  9  1  9  9  9  1  1  1  1  9  9  9  9
 2  2  9  9  9  9  9  9  9  9  9  9  9  9  9  9  9  9  9  9  9  9  9  9  9  9  9  9  9  9  9  9  9  9  9  9
 2  2  9  9  9  9  9  9  9  9  9  9  9  9  9  9  9  9  9  9  9  9  9  9  9  9  9  9  9  9  9  9  9  9  9  9
 2  2  9  9  9  9  9  9  9  9  9  9  9  9  9  9  9  9  9  9  9  9  9  9  9  9  9  9  9  9  9  9  9  9  9  9
 2  2  9  9  9  9  9  9  9  9  9  9  9  9  9  9  9  9  9  9  9  9  9  9  9  9  9  9  9  9  9  9  9  9  9  9
 2  2  9  9  9  9  9  9  9  9  9  9  9  9  9  9  9  9  9  9  9  9  9  9  9  9  9  9  9  9  9  9  9  9  9  9
 2  2  9  9  9  9  9  9  9  9  9  9  9  9  9  9  9  9  9  9  9  9  9  9  9  9  9  9  9  9  9  9  9  9  9  9
 2  2 22 22 22 22 22 22 22 22 22 22 22 22 22  2 22  2 22 22 22 22 22 22 22 22  2 22 22 22 22 22 22 22 22 22
