2 2 9 9 9 9 9 9 9 9 9 9 9 9
2 2 9 9 9 9 9 9 9 9 9 9 9 9
2 2 9 9 9 9 9 9 9 9 9 9 9 9
2 2 9 9 9 9 9 9 9 9 9 9 9 9
2 2 9 9 9 9 9 9 9 9 9 9 9 9
2 2 9 9 9 9 9 9 9 9 9 9 9 9
2 2 9 9 9 9 9 9 9 9 9 9 9 9
2 2 9 9 9 9 9 9 9 9 9 9 9 9
2 2 10 10 9 9 9 9 9 9 9 9 9 9
2 2 9 9 9 9 9 9 9 9 10 10 9 9
2 2 9 9 9 9 9 9 9 9 10 10 9 9
2 2 9 9 9 9 9 9 9 9 9 9 9 9
2 2 9 9 9 9 9 9 9 9 9 9 9 9
2 2 9 10 10 9 9 9 9 9 9 9 9 9
2 2 9 10 10 9 9 9 9 9 9 9 9 9
2 2 1 0 1 1 0 0 0 1 1 0 0 1
2 2 2 2 2 2 2 2 2 2 2 2 2 2